###########
#        0#
####   ####
#         #
#S        #
###########