##########
#       0#
#        #
#        #
#        #
#        #
#        #
#        #
#S       #
##########