###########
#         #
#  #####  #
#  #####  #
#S     0  #
###########