###########
#         #
#  #####  #
#  #####  #
#S  0     #
###########