######
#   0#
#    #
#    #
#S   #
######
