##########
#S      0#
#   #    #
#   #    #
#   #    #
#   #    #
#   #    #
#   #    #
#        #
##########