###########
#0        #
#  #####  #
#  #####  #
#S        #
###########