##########
#       0#
#   #    #
#   #    #
#   #    #
#   #    #
#   #    #
#   #    #
#S       #
##########