##########
#S      0#
#        #
#        #
#        #
#        #
#        #
#        #
#        #
##########