###########
#        0#
#  #####  #
#  #####  #
#S        #
###########