###########
#        0#
#  ##     #
#  ##     #
#S        #
#         #
#         #
###########
###########