###########
# 0       #
#  #####  #
#  #####  #
#S        #
###########